bdartan0@gizmodo.com	Dartan
ledwin1@livejournal.com	Edwin
dberringer2@deliciousdays.com	Berringer
eizkovicz3@1und1.de	Izkovicz
lclemente4@sbwire.com	Clemente
tblincow5@cornell.edu	Blincow
cplott6@narod.ru	Plott
jcrewdson7@msu.edu	Crewdson
eeloy8@canalblog.com	Eloy
trainsbury9@rambler.ru	Rainsbury
rrobillarta@house.gov	Robillart
adominguesb@gravatar.com	Domingues
kmcconnelc@google.com	McConnel
rhuntleyd@fastcompany.com	Huntley
fdeathe@cdbaby.com	D'eath
ljewsonf@technorati.com	Jewson
esissotg@merriam-webster.com	Sissot
bklewerh@booking.com	Klewer
cabryi@pinterest.com	Abry
caxbyj@fema.gov	Axby
gdrohanek@dell.com	Drohane
kkachl@over-blog.com	Kach
rbrisbanem@wsj.com	Brisbane
bforsardn@china.com.cn	Forsard
ssinkinsono@jalbum.net	Sinkinson
cburdekinp@npr.org	Burdekin
rkimmittq@zimbio.com	Kimmitt
dhantuschr@seesaa.net	Hantusch
mgoskers@google.com	Gosker
bsharplingt@themeforest.net	Sharpling
tmuffittu@mysql.com	Muffitt
mdanielkiewiczv@weather.com	Danielkiewicz
bpenhalew@phoca.cz	Penhale
plongridgex@tamu.edu	Longridge
jwhodcoaty@ebay.com	Whodcoat
aeddiez@google.com	Eddie
ffendt10@hubpages.com	Fendt
cmatous11@hostgator.com	Matous
ggiacomozzo12@state.gov	Giacomozzo
khalsey13@chronoengine.com	Halsey
lisson14@trellian.com	Isson
sbrounsell15@topsy.com	Brounsell
egordon16@angelfire.com	Gordon
smash17@gnu.org	Mash
adixsee18@ow.ly	Dixsee
hblethin19@cafepress.com	Blethin
screwes1a@elpais.com	Crewes
dparman1b@toplist.cz	Parman
mgoodered1c@about.com	Goodered
mbruyns1d@tripod.com	Bruyns
dnewiss1e@pen.io	Newiss
bbewshire1f@last.fm	Bewshire
jlittlekit1g@vk.com	Littlekit
mbardwall1h@cbc.ca	Bardwall
agiuroni1i@eventbrite.com	Giuroni
kcoldbathe1j@redcross.org	Coldbathe
cmagnus1k@netscape.com	Magnus
lthornber1l@indiatimes.com	Thornber
mcollymore1m@arizona.edu	Collymore
cgioani1n@twitter.com	Gioani
rwaberer1o@linkedin.com	Waberer
mbrandacci1p@mail.ru	Brandacci
amellodey1q@paginegialle.it	Mellodey
agohier1r@zdnet.com	Gohier
phagan1s@intel.com	Hagan
pmcwhin1t@drupal.org	McWhin
sphizacklea1u@earthlink.net	Phizacklea
dlambden1v@utexas.edu	Lambden
dsackler1w@naver.com	Sackler
vsalvatore1x@washington.edu	Salvatore
jjantet1y@fastcompany.com	Jantet
btolemache1z@wired.com	Tolemache
cconnold20@spotify.com	Connold
bclaypole21@meetup.com	Claypole
rlapre22@miibeian.gov.cn	Lapre
omcneish23@howstuffworks.com	McNeish
nomeara24@github.com	O' Meara
jhagston25@sciencedirect.com	Hagston
dthurstance26@dagondesign.com	Thurstance
averling27@umn.edu	Verling
nattfield28@google.co.uk	Attfield
mculpan29@fda.gov	Culpan
hforge2a@oakley.com	Forge
gmatiashvili2b@acquirethisname.com	Matiashvili
bknowlson2c@youku.com	Knowlson
cbehnecken2d@domainmarket.com	Behnecken
dderby2e@wordpress.org	Derby
browntree2f@un.org	Rowntree
uphilliskirk2g@businesswire.com	Philliskirk
ebritee2h@yolasite.com	Britee
cfifoot2i@tinypic.com	Fifoot
plancetter2j@rakuten.co.jp	Lancetter
vdechastelain2k@slate.com	de Chastelain
choolaghan2l@gmpg.org	Hoolaghan
dilchuk2m@whitehouse.gov	Ilchuk
blangworthy2n@joomla.org	Langworthy
sscamal2o@tripadvisor.com	Scamal
jshenton2p@squidoo.com	Shenton
skillelay2q@hubpages.com	Killelay
vcoling2r@netlog.com	Coling
rmattea2s@goodreads.com	Mattea
ksandbach2t@odnoklassniki.ru	Sandbach
jweddeburn2u@joomla.org	Weddeburn
ltresise2v@umn.edu	Tresise
hklemencic2w@networksolutions.com	Klemencic
mrycroft2x@sourceforge.net	Rycroft
rcanelas2y@ehow.com	Canelas
kstrond2z@slideshare.net	Strond
rlight30@accuweather.com	Light
ndeeson31@mayoclinic.com	Deeson
dvere32@cnbc.com	Vere
rmarchington33@pinterest.com	Marchington
rbryer34@princeton.edu	Bryer
ykitcatt35@ustream.tv	Kitcatt
rwarhurst36@cmu.edu	Warhurst
ajockle37@qq.com	Jockle
dbryer38@nasa.gov	Bryer
eshirland39@go.com	Shirland
lranvoise3a@plala.or.jp	Ranvoise
emccleary3b@unc.edu	McCleary
gpennings3c@nydailynews.com	Pennings
cdallicott3d@twitpic.com	Dallicott
ibrunton3e@wix.com	Brunton
rcufley3f@jimdo.com	Cufley
fkitchin3g@xing.com	Kitchin
sestevez3h@youtu.be	Estevez
rraxworthy3i@globo.com	Raxworthy
awandless3j@yellowpages.com	Wandless
kdunlap3k@deviantart.com	Dunlap
mrudolph3l@arizona.edu	Rudolph
macreman3m@simplemachines.org	Acreman
sdaish3n@canalblog.com	Daish
pbattershall3o@marketwatch.com	Battershall
ehowes3p@amazon.co.uk	Howes
mdalgetty3q@theguardian.com	Dalgetty
nbosward3r@nymag.com	Bosward
gglasebrook3s@google.com	Glasebrook
bpariss3t@digg.com	Pariss
lkeedwell3u@drupal.org	Keedwell
ngeydon3v@dedecms.com	Geydon
bransom3w@google.com.au	Ransom
gtalman3x@cam.ac.uk	Talman
abracken3y@princeton.edu	Bracken
eduffield3z@fema.gov	Duffield
aricket40@google.com	Ricket
bwinter41@squarespace.com	Winter
ndael42@ycombinator.com	Dael
ebouldon43@bandcamp.com	Bouldon
mverdun44@blogger.com	Verdun
jcussen45@noaa.gov	Cussen
ntidbold46@scientificamerican.com	Tidbold
sfernez47@gizmodo.com	Fernez
bmacandrew48@vinaora.com	MacAndrew
mbernardo49@nytimes.com	Bernardo
dbehr4a@msn.com	Behr
halliberton4b@sfgate.com	Alliberton
gfessier4c@skype.com	Fessier
sdomanski4d@seesaa.net	Domanski
ajoddens4e@ucoz.ru	Joddens
cwoodcroft4f@shutterfly.com	Woodcroft
jpitherick4g@bloglovin.com	Pitherick
fshallow4h@microsoft.com	Shallow
bpurkiss4i@kickstarter.com	Purkiss
jchitter4j@mac.com	Chitter
jpursglove4k@gizmodo.com	Pursglove
drubinek4l@about.com	Rubinek
edank4m@storify.com	Dank
clivingstone4n@gov.uk	Livingstone
nlamyman4o@shutterfly.com	Lamyman
dgethen4p@imageshack.us	Gethen
rcatcheside4q@ovh.net	Catcheside
cberrisford4r@godaddy.com	Berrisford
ccodi4s@friendfeed.com	Codi
jodcroft4t@go.com	Odcroft
celcocks4u@businessinsider.com	Elcocks
zfidge4v@typepad.com	Fidge
mwellbank4w@facebook.com	Wellbank
dbritner4x@wisc.edu	Britner
afoskett4y@ovh.net	Foskett
etewes4z@paypal.com	Tewes
ssket50@xrea.com	Sket
hovid51@reference.com	Ovid
kjurgensen52@msu.edu	Jurgensen
tcorbyn53@123-reg.co.uk	Corbyn
gcressar54@multiply.com	Cressar
sgiocannoni55@wisc.edu	Giocannoni
efrisch56@hud.gov	Frisch
mshevelin57@webs.com	Shevelin
kweall58@yelp.com	Weall
tdensie59@de.vu	Densie
kmoller5a@cnbc.com	Moller
ddemico5b@java.com	De Mico
zfirbank5c@devhub.com	Firbank
eluxon5d@ucoz.ru	Luxon
frotte5e@harvard.edu	Rotte
cheigold5f@umich.edu	Heigold
fgowman5g@livejournal.com	Gowman
kstork5h@mysql.com	Stork
hmerriday5i@hugedomains.com	Merriday
mslocket5j@apache.org	Slocket
amarvin5k@hao123.com	Marvin
mmcelrea5l@icio.us	McElrea
kcaven5m@soundcloud.com	Caven
estartin5n@plala.or.jp	Startin
emowbray5o@histats.com	Mowbray
cwherton5p@bloglovin.com	Wherton
flarose5q@clickbank.net	Larose
sslite5r@icq.com	Slite
mmcmahon5s@hatena.ne.jp	McMahon
cjillions5t@hud.gov	Jillions
spaylie5u@boston.com	Paylie
bchaundy5v@auda.org.au	Chaundy
apenke5w@wix.com	Penke
amcewan5x@netscape.com	McEwan
dfrancklin5y@guardian.co.uk	Francklin
ledgington5z@webs.com	Edgington
mveneur60@reddit.com	Veneur
credolfi61@taobao.com	Redolfi
gberre62@netvibes.com	Berre
tburdfield63@fastcompany.com	Burdfield
abadland64@taobao.com	Badland
lrittelmeyer65@go.com	Rittelmeyer
jneale66@ed.gov	Neale
sgeach67@51.la	Geach
earsnell68@facebook.com	Arsnell
agrimsdell69@reuters.com	Grimsdell
ctemple6a@tiny.cc	Temple
rbranch6b@utexas.edu	Branch
cmandry6c@virginia.edu	Mandry
lsunnucks6d@miitbeian.gov.cn	Sunnucks
sosesnane6e@zimbio.com	O'Sesnane
bceresa6f@cornell.edu	Ceresa
dsilburn6g@discuz.net	Silburn
vpiggot6h@sciencedaily.com	Piggot
jberrycloth6i@ft.com	Berrycloth
kmcvey6j@merriam-webster.com	McVey
acassar6k@livejournal.com	Cassar
hcanon6l@techcrunch.com	Canon
bmcmechan6m@wordpress.org	Mc Mechan
hmceneny6n@abc.net.au	McEneny
cdonat6o@blogger.com	Donat
cflaxon6p@drupal.org	Flaxon
wgarvin6q@washington.edu	Garvin
dsongust6r@usgs.gov	Songust
ecompton6s@businesswire.com	Compton
jbeaument6t@paginegialle.it	Beaument
lrounds6u@youtube.com	Rounds
asnelling6v@t.co	Snelling
mmorales6w@w3.org	Morales
precher6x@ted.com	Recher
jheyburn6y@newyorker.com	Heyburn
jpegden6z@is.gd	Pegden
silden70@chronoengine.com	Ilden
sdunkerley71@prweb.com	Dunkerley
tchiverstone72@quantcast.com	Chiverstone
njohnston73@jimdo.com	Johnston
uschlagman74@wikia.com	Schlagman
bepiscopi75@foxnews.com	Episcopi
cspaingower76@hao123.com	Spain-Gower
oscardifield77@marriott.com	Scardifield
pberrisford78@google.com.hk	Berrisford
anezey79@vkontakte.ru	Nezey
trivett7a@yellowbook.com	Rivett
lspraggs7b@intel.com	Spraggs
llangton7c@marketwatch.com	Langton
ashellum7d@mail.ru	Shellum
cbuney7e@about.com	Buney
acarnilian7f@tamu.edu	Carnilian
eberzin7g@elpais.com	Berzin
wcarss7h@last.fm	Carss
forhrt7i@scientificamerican.com	Orhrt
nniave7j@blogspot.com	Niave
mgomes7k@flickr.com	Gomes
plandeaux7l@scribd.com	Landeaux
mteodorski7m@lulu.com	Teodorski
cdarcey7n@chicagotribune.com	Darcey
kmelton7o@stumbleupon.com	Melton
tbolley7p@imgur.com	Bolley
gbanstead7q@businessweek.com	Banstead
gsurgey7r@alexa.com	Surgey
gruprecht7s@paginegialle.it	Ruprecht
rhuxter7t@wsj.com	Huxter
kkelloch7u@trellian.com	Kelloch
bbulfoot7v@hatena.ne.jp	Bulfoot
nhumphries7w@unicef.org	Humphries
cmauser7x@businessinsider.com	Mauser
ajeannard7y@photobucket.com	Jeannard
scullnean7z@jalbum.net	Cullnean
gbeville80@ustream.tv	Beville
lryley81@bloomberg.com	Ryley
hhellier82@blogtalkradio.com	Hellier
rdonett83@cisco.com	Donett
whunston84@biglobe.ne.jp	Hunston
lrowland85@ustream.tv	Rowland
wstiven86@washington.edu	Stiven
gyakovl87@wikipedia.org	Yakovl
rangood88@virginia.edu	Angood
mcaughte89@e-recht24.de	Caughte
lquiddinton8a@woothemes.com	Quiddinton
edimnage8b@bluehost.com	Dimnage
ggerleit8c@home.pl	Gerleit
heasterfield8d@issuu.com	Easterfield
dmarquis8e@issuu.com	Marquis
mleschelle8f@spotify.com	Leschelle
bcluitt8g@geocities.jp	Cluitt
dashard8h@imgur.com	Ashard
gpenbarthy8i@walmart.com	Penbarthy
llumb8j@abc.net.au	Lumb
sgores8k@uiuc.edu	Gores
gverdy8l@issuu.com	Verdy
onutbrown8m@pbs.org	Nutbrown
jbaggarley8n@miitbeian.gov.cn	Baggarley
aroblett8o@pinterest.com	Roblett
ksuermeier8p@infoseek.co.jp	Suermeier
ttarry8q@sina.com.cn	Tarry
ggethings8r@ameblo.jp	Gethings
gdavidge8s@answers.com	Davidge
chaye8t@newyorker.com	Haye
ckeywood8u@plala.or.jp	Keywood
rivanuschka8v@ca.gov	Ivanuschka
gshimmin8w@irs.gov	Shimmin
cbohden8x@barnesandnoble.com	Bohden
gkears8y@go.com	Kears
ddallaghan8z@nbcnews.com	Dallaghan
nklaggeman90@flavors.me	Klaggeman
bherley91@bandcamp.com	Herley
lbirwhistle92@epa.gov	Birwhistle
hjonathon93@shop-pro.jp	Jonathon
grutledge94@unicef.org	Rutledge
mburrage95@typepad.com	Burrage
rbracci96@lulu.com	Bracci
agrocock97@behance.net	Grocock
jschmidt98@google.com.br	Schmidt
ajaffra99@hostgator.com	Jaffra
sebbage9a@wunderground.com	Ebbage
kphilipsen9b@sciencedirect.com	Philipsen
bmeachem9c@goo.ne.jp	Meachem
dohern9d@weebly.com	O' Hern
jklimsch9e@jimdo.com	Klimsch
tlestrange9f@stanford.edu	Le Strange
kadamiak9g@ebay.com	Adamiak
acaudell9h@chron.com	Caudell
dholborn9i@livejournal.com	Holborn
pguage9j@ucsd.edu	Guage
dfayer9k@marriott.com	Fayer
bmullins9l@aol.com	Mullins
gorgen9m@chicagotribune.com	Orgen
cpalser9n@newyorker.com	Palser
jsharp9o@so-net.ne.jp	Sharp
bryce9p@about.com	Ryce
ashafe9q@nyu.edu	Shafe
hpearcy9r@army.mil	Pearcy
mcanto9s@so-net.ne.jp	Canto
aoxer9t@icq.com	Oxer
mcoggin9u@flickr.com	Coggin
jbeton9v@cnn.com	Beton
kdamrell9w@cpanel.net	Damrell
hwhelan9x@accuweather.com	Whelan
ehowlings9y@yale.edu	Howlings
mbazell9z@wunderground.com	Bazell
sklishina0@vk.com	Klishin
asettlea1@diigo.com	Settle
rmoyseya2@meetup.com	Moysey
spigneya3@msu.edu	Pigney
echiechioa4@google.ca	Chiechio
mpresideya5@merriam-webster.com	Presidey
bciceroa6@linkedin.com	Cicero
vburlanda7@mozilla.org	Burland
aocrottya8@ft.com	O'Crotty
gabthorpea9@weibo.com	Abthorpe
teasonaa@netscape.com	Eason
mpingab@e-recht24.de	Ping
amaccookac@example.com	MacCook
ddeddumad@nsw.gov.au	Deddum
ecockshotae@apache.org	Cockshot
ldecristofaloaf@phpbb.com	De Cristofalo
cedmondsag@goodreads.com	Edmonds
myakobovitzah@harvard.edu	Yakobovitz
lvanniai@reference.com	Vanni
ytirteaj@cdbaby.com	Tirte
ipickersailak@gravatar.com	Pickersail
bstookal@multiply.com	Stook
ppaulouam@reddit.com	Paulou
gheinrician@arizona.edu	Heinrici
rbrookesbieao@bluehost.com	Brookesbie
hskoggingsap@wp.com	Skoggings
dshurrockaq@cbsnews.com	Shurrock
ashieberar@google.com.hk	Shieber
rkivitsas@vk.com	Kivits
cbartolijnat@diigo.com	Bartolijn
vadamsonau@free.fr	Adamson
rcraggav@blog.com	Cragg
estraussaw@creativecommons.org	Strauss
ngarrattleyax@studiopress.com	Garrattley
mdupreyay@guardian.co.uk	Duprey
dsadleraz@guardian.co.uk	Sadler
asearightb0@lulu.com	Searight
hraysonb1@tuttocitta.it	Rayson
idanburyb2@google.com.hk	Danbury
bjindrakb3@sakura.ne.jp	Jindrak
chaughinb4@de.vu	Haughin
bvolonteb5@miibeian.gov.cn	Volonte
nschwiesob6@epa.gov	Schwieso
mpelzb7@yellowpages.com	Pelz
rnanab8@cornell.edu	Nana
gbellasb9@cloudflare.com	Bellas
fproseba@livejournal.com	Prose
krusebb@issuu.com	Ruse
crehorbc@t-online.de	Rehor
nibotsonbd@example.com	Ibotson
amccloughenbe@over-blog.com	McCloughen
vcherrettbf@npr.org	Cherrett
dhousegoebg@geocities.jp	Housegoe
rsobczakbh@diigo.com	Sobczak
orodwaybi@so-net.ne.jp	Rodway
tgrindallbj@springer.com	Grindall
asignbk@issuu.com	Sign
lwardesworthbl@icq.com	Wardesworth
ddenevebm@storify.com	Deneve
cstuehmeierbn@japanpost.jp	Stuehmeier
ofarnallbo@linkedin.com	Farnall
mdecrusebp@bluehost.com	Decruse
mmacmasterbq@europa.eu	MacMaster
ctrowbr@vimeo.com	Trow
kfishendenbs@hud.gov	Fishenden
soscandallbt@apple.com	O'Scandall
aambrosinibu@un.org	Ambrosini
bgratrexbv@nba.com	Gratrex
charknessbw@imdb.com	Harkness
ghulancebx@arstechnica.com	Hulance
ayeudallby@ibm.com	Yeudall
tmairbz@networkadvertising.org	Mair
mtrahearnc0@hostgator.com	Trahearn
abernadzkic1@google.fr	Bernadzki
tlouisotc2@photobucket.com	Louisot
uardleyc3@multiply.com	Ardley
dalderwickc4@weebly.com	Alderwick
atoffalonic5@mlb.com	Toffaloni
cgurgec6@icio.us	Gurge
gmckeowonc7@youtu.be	McKeowon
emckinnonc8@free.fr	McKinnon
bgiacubboc9@mozilla.com	Giacubbo
dgeelyca@wordpress.org	Geely
lfriddcb@umn.edu	Fridd
cheapcc@mit.edu	Heap
ewigelsworthcd@miitbeian.gov.cn	Wigelsworth
fdegiovannice@illinois.edu	De Giovanni
ekirtlancf@slashdot.org	Kirtlan
lbraznellcg@mashable.com	Braznell
ckitsch@economist.com	Kits
mbrodleyci@arstechnica.com	Brodley
aprenecj@wp.com	Prene
gadriaanck@rediff.com	Adriaan
ddunncl@joomla.org	Dunn
acuthbertsoncm@seesaa.net	Cuthbertson
pcrichmercn@myspace.com	Crichmer
cburgoyneco@networksolutions.com	Burgoyne
jjarroldcp@thetimes.co.uk	Jarrold
dsmycq@wunderground.com	Smy
tbraunstoncr@weather.com	Braunston
tcostelloecs@google.nl	Costelloe
mcorbenct@example.com	Corben
cverlingcu@wikia.com	Verling
scliburncv@aol.com	Cliburn
scorrecw@joomla.org	Corre
sabramamovhcx@seesaa.net	Abramamovh
lmelsomecy@github.io	Melsome
dmajurycz@sciencedaily.com	Majury
educkitd0@dagondesign.com	Duckit
dgilgrystd1@samsung.com	Gilgryst
gbondesend2@ovh.net	Bondesen
baitkenheadd3@blogspot.com	Aitkenhead
ytremayned4@flickr.com	Tremayne
pandrosikd5@dailymail.co.uk	Androsik
lcallawayd6@nasa.gov	Callaway
dbrockestd7@vistaprint.com	Brockest
flibbeyd8@cbc.ca	Libbey
ctarbettd9@bing.com	Tarbett
tsouthernsda@ca.gov	Southerns
ahebbornedb@berkeley.edu	Hebborne
gtowedc@bloomberg.com	Towe
jquenbydd@dyndns.org	Quenby
hwhightde@friendfeed.com	Whight
cdaiddf@meetup.com	Daid
sevesquedg@friendfeed.com	Evesque
htreveardh@booking.com	Trevear
jroomedi@sciencedaily.com	Roome
hgreensmithdj@people.com.cn	Greensmith
akalinskydk@4shared.com	Kalinsky
pwarfielddl@delicious.com	Warfield
ccorpesdm@bigcartel.com	Corpes
lhassentdn@mapquest.com	Hassent
elezemeredo@networkadvertising.org	Lezemere
dballsdp@timesonline.co.uk	Balls
abewsheadq@infoseek.co.jp	Bewshea
ndyettdr@devhub.com	Dyett
jvasyukovds@people.com.cn	Vasyukov
rjiggensdt@nyu.edu	Jiggens
rseifenmacherdu@w3.org	Seifenmacher
dohonedv@soup.io	O'Hone
jsockelldw@unesco.org	Sockell
tstockportdx@cisco.com	Stockport
dmoncreiffdy@si.edu	Moncreiff
tmellanddz@ocn.ne.jp	Melland
lloughrene0@blogger.com	Loughren
sbryane1@jiathis.com	Bryan
binstone2@php.net	Inston
kbrandlee3@bizjournals.com	Brandle
dcharrettee4@behance.net	Charrette
cfirbanke5@google.cn	Firbank
dlambote6@ning.com	Lambot
cpulmane7@yahoo.co.jp	Pulman
csturrocke8@e-recht24.de	Sturrock
pshimonie9@guardian.co.uk	Shimoni
pnystromea@europa.eu	Nystrom
jrutherfortheb@reference.com	Rutherforth
eorrobinec@craigslist.org	Orrobin
ebonwelled@myspace.com	Bonwell
dgronalleree@skyrock.com	Gronaller
bpindellef@google.cn	Pindell
nspoureeg@g.co	Spoure
ccastertoneh@huffingtonpost.com	Casterton
thayseyei@archive.org	Haysey
rcregganej@blogger.com	Creggan
lbattsonek@miitbeian.gov.cn	Battson
collenbuttelel@ucoz.com	Ollenbuttel
zspikinsem@marriott.com	Spikins
dgladebecken@acquirethisname.com	Gladebeck
kditchburneo@cnbc.com	Ditchburn
gredfieldep@desdev.cn	Redfield
cainscougheq@freewebs.com	Ainscough
groffeyer@ucoz.com	Roffey
ddeplacidoes@flavors.me	Deplacido
wrashleighet@dedecms.com	Rashleigh
meayrseu@twitpic.com	Eayrs
dcalderwoodev@blinklist.com	Calderwood
qpittetew@xrea.com	Pittet
lhillanex@is.gd	Hillan
mtroyey@pbs.org	Troy
iduffez@dagondesign.com	Duff
sjedrasikf0@archive.org	Jedrasik
bsanperef1@fda.gov	Sanpere
kgealf2@hatena.ne.jp	Geal
agrinyovf3@slashdot.org	Grinyov
cgozneyf4@meetup.com	Gozney
hblythinf5@multiply.com	Blythin
hvaslerf6@wikimedia.org	Vasler
oliebf7@domainmarket.com	Lieb
ecurtisf8@flickr.com	Curtis
cscarlanf9@telegraph.co.uk	Scarlan
vgunnfa@vinaora.com	Gunn
bleclairefb@google.nl	Le Claire
alindstedtfc@imageshack.us	Lindstedt
lburtenshawfd@miibeian.gov.cn	Burtenshaw
afredsonfe@jiathis.com	Fredson
mmeagherff@cdbaby.com	Meagher
cpearceyfg@tumblr.com	Pearcey
ctynnanfh@reddit.com	Tynnan
mclarabutfi@com.com	Clarabut
karnholtzfj@icio.us	Arnholtz
jdudgeonfk@yellowbook.com	Dudgeon
cbutlinfl@usnews.com	Butlin
ifrowingfm@house.gov	Frowing
cdaelfn@discovery.com	Dael
syeendfo@techcrunch.com	Yeend
jgergfp@nymag.com	Gerg
glaisefq@psu.edu	Laise
kwindfr@omniture.com	Wind
mvaneedenfs@ucoz.com	Van Eeden
gbilliardft@cam.ac.uk	Billiard
srostonfu@harvard.edu	Roston
gtillardfv@statcounter.com	Tillard
pleckeyfw@prlog.org	Leckey
mdarbonfx@angelfire.com	Darbon
stunnickfy@engadget.com	Tunnick
pwilgarfz@nps.gov	Wilgar
gdudingg0@sakura.ne.jp	Duding
gcastreeg1@sakura.ne.jp	Castree
fhastilowg2@mashable.com	Hastilow
skalbg3@privacy.gov.au	Kalb
wrosinag4@edublogs.org	Rosina
ksunnerg5@surveymonkey.com	Sunner
fboheag6@lulu.com	Bohea
lohlseng7@apache.org	Ohlsen
bvanyuting8@stumbleupon.com	Vanyutin
tcabrerag9@sogou.com	Cabrera
fpoleykettga@deviantart.com	Poleykett
coxenburygb@twitter.com	Oxenbury
tfreundgc@globo.com	Freund
fwhodcoatgd@wufoo.com	Whodcoat
vlysge@oaic.gov.au	Lys
bantonellinigf@digg.com	Antonellini
klamartinegg@blogger.com	Lamartine
ddeguisegh@spiegel.de	de Guise
gchildsgi@baidu.com	Childs
mskingj@google.cn	Skin
telfleetgk@people.com.cn	Elfleet
dherrerangl@hibu.com	Herreran
wsewardsgm@telegraph.co.uk	Sewards
jpikhnogn@businesswire.com	Pikhno
acainesgo@stumbleupon.com	Caines
aattenburrowgp@whitehouse.gov	Attenburrow
rgonoudegq@mac.com	Gonoude
mhuckgr@mozilla.org	Huck
kdeevesgs@canalblog.com	Deeves
vportwaingt@bravesites.com	Portwain
ichartersgu@bing.com	Charters
ehoyesgv@wufoo.com	Hoyes
cbridgwatergw@istockphoto.com	Bridgwater
scruddasgx@taobao.com	Cruddas
amcewengy@newyorker.com	McEwen
pmaystongz@bandcamp.com	Mayston
aastlingh0@home.pl	Astling
fsaundersonh1@miitbeian.gov.cn	Saunderson
gwaineh2@ox.ac.uk	Waine
rjouannyh3@boston.com	Jouanny
jdurranth4@furl.net	Durrant
lmanochh5@fotki.com	Manoch
rgullenh6@yellowpages.com	Gullen
jhellyarh7@xinhuanet.com	Hellyar
eslamakerh8@nytimes.com	Slamaker
mokennavainh9@myspace.com	O'Kennavain
mweepersha@studiopress.com	Weepers
eworshallhb@arstechnica.com	Worshall
jleadeshc@vistaprint.com	Leades
uwinsburyhd@chron.com	Winsbury
rboggonhe@skype.com	Boggon
pmartineauhf@51.la	Martineau
orowdellhg@dion.ne.jp	Rowdell
nreichhardthh@google.ca	Reichhardt
bgarzahi@geocities.com	Garza
rlorkinhj@1und1.de	Lorkin
nrawdallhk@cisco.com	Rawdall
mpeerhl@g.co	Peer
rmulchronehm@omniture.com	Mulchrone
dknowleshn@mtv.com	Knowles
kgrancherho@huffingtonpost.com	Grancher
astenthp@usa.gov	Stent
aregglarhq@ft.com	Regglar
etolworthiehr@4shared.com	Tolworthie
lreviehs@slate.com	Revie
eorchardht@4shared.com	Orchard
kkattehu@posterous.com	Katte
rmarcinkushv@mail.ru	Marcinkus
emulreanhw@nasa.gov	Mulrean
glicquorishhx@myspace.com	Licquorish
ngamblinhy@biblegateway.com	Gamblin
vbrashhz@usda.gov	Brash
deckfordi0@livejournal.com	Eckford
bsymmsi1@japanpost.jp	Symms
emelsomi2@taobao.com	Melsom
amclesei3@arstechnica.com	McLese
mkennleri4@1und1.de	Kennler
avosperi5@ucoz.com	Vosper
khousdeni6@desdev.cn	Housden
jsnoadi7@hubpages.com	Snoad
kgerrieti8@yandex.ru	Gerriet
abaxstari9@wired.com	Baxstar
rsawbridgeia@merriam-webster.com	Sawbridge
bbueyib@telegraph.co.uk	Buey
gmcquakeric@imageshack.us	McQuaker
esavilid@shinystat.com	Savil
corridgeie@howstuffworks.com	Orridge
dknowlmanif@shutterfly.com	Knowlman
mvigerig@sciencedirect.com	Viger
sbevissih@usda.gov	Beviss
sbraikenridgeii@spotify.com	Braikenridge
cdurstonij@addthis.com	Durston
rhurstik@oakley.com	Hurst
cambrogioil@bizjournals.com	Ambrogio
eleaneyim@tripod.com	Leaney
dplampinin@printfriendly.com	Plampin
rlipscombio@bloomberg.com	Lipscomb
tcurmiip@cpanel.net	Curmi
hmapsoniq@multiply.com	Mapson
ftomischir@amazonaws.com	Tomisch
slynskeyis@npr.org	Lynskey
tpetersonit@arizona.edu	Peterson
lhurlingiu@blogtalkradio.com	Hurling
jmetsoniv@reference.com	Metson
ggateshilliw@miibeian.gov.cn	Gateshill
fcullipix@miibeian.gov.cn	Cullip
mlehrmanniy@webmd.com	Lehrmann
lawtoniz@mediafire.com	Awton
sahlfj0@youku.com	Ahlf
pluckcockj1@blogger.com	Luckcock
jcassonj2@marriott.com	Casson
wboaysj3@earthlink.net	Boays
phindsbergj4@umn.edu	Hindsberg
epenrethj5@shinystat.com	Penreth
whaversumj6@tuttocitta.it	Haversum
kregglerj7@yelp.com	Reggler
svidgenj8@last.fm	Vidgen
ghenstonej9@feedburner.com	Henstone
wheckleja@youtu.be	Heckle
momondjb@bloglines.com	Omond
fphilippetjc@php.net	Philippet
vrauprichjd@mashable.com	Rauprich
acrummieje@is.gd	Crummie
edillintonjf@scribd.com	Dillinton
twishartjg@blogspot.com	Wishart
odampneyjh@joomla.org	Dampney
ggrayhamji@google.fr	Grayham
spiochjj@stanford.edu	Pioch
fgatlandjk@clickbank.net	Gatland
tsimonatojl@slideshare.net	Simonato
etideyjm@geocities.jp	Tidey
ocasazzajn@youtu.be	Casazza
sgrimbaldestonjo@lulu.com	Grimbaldeston
bbonsalljp@google.pl	Bonsall
cgoodlakejq@oakley.com	Goodlake
cturmelljr@soup.io	Turmell
disakovicjs@biblegateway.com	Isakovic
mpointinjt@salon.com	Pointin
lhamshereju@eepurl.com	Hamshere
gwindowsjv@buzzfeed.com	Windows
xstennerjw@narod.ru	Stenner
jvillaltajx@gmpg.org	Villalta
lgarejy@canalblog.com	Gare
lmckeurtonjz@hud.gov	McKeurton
jadawayk0@example.com	Adaway
corredk1@mac.com	Orred
gmccrackenk2@free.fr	McCracken
ogreenacrek3@furl.net	Greenacre
ssockellk4@wikipedia.org	Sockell
htreacyk5@nymag.com	Treacy
cstuddek6@newsvine.com	Studde
sgraberk7@networksolutions.com	Graber
kharnesk8@etsy.com	Harnes
edreamerk9@comsenz.com	Dreamer
bbrickhillka@sfgate.com	Brickhill
kwinchcumkb@lulu.com	Winchcum
gwipperkc@pen.io	Wipper
bshireskd@miibeian.gov.cn	Shires
dsimecekke@sina.com.cn	Simecek
sglasscookf@fotki.com	Glasscoo
cpollardkg@wikia.com	Pollard
jstellekh@vkontakte.ru	Stelle
jschutzeki@icio.us	Schutze
daindraiskj@canalblog.com	Aindrais
smcgintykk@wordpress.com	McGinty
lvillekl@wufoo.com	Ville
eshemmanskm@drupal.org	Shemmans
npetrishchevkn@blogs.com	Petrishchev
mescalerako@arstechnica.com	Escalera
rteaguekp@reddit.com	Teague
kcrilleykq@independent.co.uk	Crilley
gtayekr@cam.ac.uk	Taye
lbolamks@nsw.gov.au	Bolam
radelmankt@sina.com.cn	Adelman
cericssonku@microsoft.com	Ericsson
gtappkv@webeden.co.uk	Tapp
mgrimseykw@house.gov	Grimsey
aferaghkx@youtube.com	Feragh
jfilsonky@unicef.org	Filson
iholehousekz@seesaa.net	Holehouse
tquiltyl0@indiatimes.com	Quilty
acabedol1@nps.gov	Cabedo
phanshawl2@uol.com.br	Hanshaw
jhagerghaml3@craigslist.org	Hagergham
tsharpleyl4@webnode.com	Sharpley
fmertgenl5@globo.com	Mertgen
kbasezzil6@de.vu	Basezzi
ecransonl7@g.co	Cranson
vwhittakerl8@privacy.gov.au	Whittaker
mvanzonl9@mashable.com	Van Zon
klileyla@nymag.com	Liley
vtripetlb@indiegogo.com	Tripet
whearseylc@chronoengine.com	Hearsey
xplunketld@instagram.com	Plunket
eiacobettole@nature.com	Iacobetto
lalvareslf@mediafire.com	Alvares
ebosencelg@360.cn	Bosence
mswettenhamlh@independent.co.uk	Swettenham
bmathyli@sun.com	Mathy
hroukelj@google.co.uk	Rouke
cbofieldlk@china.com.cn	Bofield
mkitleell@booking.com	Kitlee
rrickeardlm@europa.eu	Rickeard
rmccurrieln@about.me	McCurrie
gdumbltonlo@princeton.edu	Dumblton
mdacostalp@archive.org	Costa
lfarquharsonlq@marriott.com	Farquharson
adollinglr@techcrunch.com	Dolling
bmacrannellls@angelfire.com	MacRannell
mmailelt@opensource.org	Maile
clanbertonilu@newyorker.com	Lanbertoni
bmaccolelv@bloglovin.com	MacCole
sengledowlw@meetup.com	Engledow
cbrownswordlx@privacy.gov.au	Brownsword
bcureely@europa.eu	Curee
mnencilz@photobucket.com	Nenci
wabendrothm0@wordpress.com	Abendroth
drotherym1@nasa.gov	Rothery
clathamm2@typepad.com	Latham
cpfaffelm3@technorati.com	Pfaffel
lrobathonm4@pbs.org	Robathon
iemmerm5@mozilla.com	Emmer
lmccronem6@psu.edu	McCrone
btubbsm7@ucsd.edu	Tubbs
gleadsm8@intel.com	Leads
aheiblm9@rediff.com	Heibl
dtweedyma@trellian.com	Tweedy
hrallingmb@answers.com	Ralling
rbrewettmc@mlb.com	Brewett
rgyurkovicsmd@taobao.com	Gyurkovics
dkivitsme@arstechnica.com	Kivits
vbottomleymf@ftc.gov	Bottomley
tbonnickmg@nifty.com	Bonnick
aconklinmh@pbs.org	Conklin
cantonuccimi@ebay.co.uk	Antonucci
cecclestonemj@delicious.com	Ecclestone
deaglestonemk@w3.org	Eaglestone
bronischml@ihg.com	Ronisch
ciacovidesmm@usgs.gov	Iacovides
rcomstymn@state.tx.us	Comsty
nopperymo@craigslist.org	Oppery
kringmp@github.io	Ring
ghicksmq@symantec.com	Hicks
fwhytemanmr@netscape.com	Whyteman
ajanusikms@un.org	Janusik
dlivickmt@pagesperso-orange.fr	Livick
tkarpinskimu@nymag.com	Karpinski
rsavatiermv@theguardian.com	Savatier
dranniganmw@symantec.com	Rannigan
rdorningmx@mapquest.com	Dorning
dsiggemy@themeforest.net	Sigge
epidgeleymz@infoseek.co.jp	Pidgeley
awhetnalln0@myspace.com	Whetnall
kbreedsn1@google.co.uk	Breeds
abeaden2@opensource.org	Beade
rstrangewaysn3@artisteer.com	Strangeways
raddeycottn4@forbes.com	Addeycott
ebankn5@huffingtonpost.com	Bank
ecorstorphinen6@baidu.com	Corstorphine
jsiddaleyn7@phoca.cz	Siddaley
cpennycockn8@imdb.com	Pennycock
crosengrenn9@privacy.gov.au	Rosengren
kjackna@mozilla.com	Jack
ogarmannb@cam.ac.uk	Garman
eearlnc@hexun.com	Earl
csabynd@vk.com	Saby
ewrankmorene@cloudflare.com	Wrankmore
emeadowcraftnf@liveinternet.ru	Meadowcraft
scurlessng@stanford.edu	Curless
srichfordnh@so-net.ne.jp	Richford
rgeraldezni@usgs.gov	Geraldez
isuffnj@arizona.edu	Suff
sdellenbroknk@slideshare.net	Dellenbrok
gferrynl@si.edu	Ferry
civanishevnm@cloudflare.com	Ivanishev
svalentinonn@purevolume.com	Valentino
bastno@nydailynews.com	Ast
shyattnp@irs.gov	Hyatt
dkaresnq@flickr.com	Kares
mromeronr@com.com	Romero
ynickollns@oaic.gov.au	Nickoll
pdaillynt@ovh.net	Dailly
gpucknellnu@devhub.com	Pucknell
rpagettnv@domainmarket.com	Pagett
dcitrinenw@hibu.com	Citrine
gwegmannx@wikia.com	Wegman
pflacknellny@hatena.ne.jp	Flacknell
wbaxsternz@symantec.com	Baxster
hlegerwoodo0@domainmarket.com	Legerwood
mcrellimo1@purevolume.com	Crellim
rwoolgaro2@redcross.org	Woolgar
tboutflouro3@vk.com	Boutflour
efawthropo4@drupal.org	Fawthrop
iwylamo5@princeton.edu	Wylam
jproudo6@slideshare.net	Proud
rtilsono7@state.gov	Tilson
bhogbino8@github.io	Hogbin
cknottleyo9@shutterfly.com	Knottley
vtumiotooa@blog.com	Tumioto
cnozzoliiob@google.ca	Nozzolii
tlardezoc@smh.com.au	Lardez
tcobleighod@example.com	Cobleigh
ngreeveoe@time.com	Greeve
gskermerof@psu.edu	Skermer
vbaldenog@archive.org	Balden
reasonoh@sohu.com	Eason
iocurraneoi@mapy.cz	O'Currane
ljeffreyoj@a8.net	Jeffrey
erayntonok@addtoany.com	Raynton
dtanteol@123-reg.co.uk	Tante
oattawellom@ameblo.jp	Attawell
mtunnowon@zdnet.com	Tunnow
eedgecumbeoo@woothemes.com	Edgecumbe
jleeceop@flavors.me	Leece
etwellsoq@examiner.com	Twells
dholbyor@usgs.gov	Holby
bkeillohos@nsw.gov.au	Keilloh
agisbeyot@booking.com	Gisbey
jsheersou@wisc.edu	Sheers
alubertiov@nps.gov	Luberti
gbathow@quantcast.com	Bath
amacarteox@ameblo.jp	MacArte
qwhybrowoy@purevolume.com	Whybrow
ktowndrowoz@homestead.com	Towndrow
saggliop0@sun.com	Agglio
dlawlessp1@comcast.net	Lawless
smadrep2@ucoz.com	Madre
iondricekp3@github.com	Ondricek
fmalmarp4@livejournal.com	Malmar
osomnerp5@oracle.com	Somner
cpratchettp6@europa.eu	Pratchett
dglassborowp7@posterous.com	Glassborow
rgraffinp8@tinyurl.com	Graffin
ytimmsp9@flavors.me	Timms
mbilneypa@hostgator.com	Bilney
ckohnpb@google.cn	Kohn
grawlencepc@chronoengine.com	Rawlence
mabbotsonpd@sphinn.com	Abbotson
mhafnerpe@forbes.com	Hafner
apaveypf@scientificamerican.com	Pavey
amcgettiganpg@ycombinator.com	McGettigan
chonywillph@prnewswire.com	Honywill
vendeanpi@engadget.com	Endean
hdamiralpj@live.com	Damiral
hcansfieldpk@cpanel.net	Cansfield
lbuckleighpl@multiply.com	Buckleigh
dpriddeypm@eepurl.com	Priddey
hkirschepn@home.pl	Kirsche
cshinnpo@salon.com	Shinn
fmabepp@usa.gov	Mabe
bwisbeypq@pcworld.com	Wisbey
skinnachpr@si.edu	Kinnach
pegleofgermanyps@clickbank.net	Egle of Germany
htointonpt@cloudflare.com	Tointon
aguillfordpu@comcast.net	Guillford
jtroakepv@cargocollective.com	Troake
jbohlinpw@discuz.net	Bohlin
dgleaderpx@over-blog.com	Gleader
abullaspy@earthlink.net	Bullas
gcrewtherpz@issuu.com	Crewther
fmounterq0@cnbc.com	Mounter
lhaileq1@bravesites.com	Haile
dbickerdikeq2@webeden.co.uk	Bickerdike
ehallawaysq3@jugem.jp	Hallaways
rmcparlinq4@istockphoto.com	McParlin
mdallasq5@mail.ru	Dallas
wjakuszewskiq6@so-net.ne.jp	Jakuszewski
aglennonq7@usnews.com	Glennon
nespinolaq8@ifeng.com	Espinola
kgheorghieq9@businessweek.com	Gheorghie
shawseqa@latimes.com	Hawse
jedysonqb@guardian.co.uk	Edyson
bbaylieqc@eventbrite.com	Baylie
ebovingdonqd@mozilla.com	Bovingdon
hfranchioniqe@sciencedaily.com	Franchioni
tbrocketqf@economist.com	Brocket
aphibbqg@google.com.au	Phibb
lkendrewqh@indiatimes.com	Kendrew
sogormleyqi@github.com	O'Gormley
wevasonqj@google.com	Evason
cbelseyqk@bigcartel.com	Belsey
dhaldinql@washingtonpost.com	Haldin
sgaltonqm@nature.com	Galton
cscardafieldqn@csmonitor.com	Scardafield
ntrevillionqo@ca.gov	Trevillion
nrupertqp@livejournal.com	Rupert
rhorleyqq@meetup.com	Horley
cmockesqr@artisteer.com	Mockes
rroselqs@nba.com	Rosel
dcurnockqt@etsy.com	Curnock
hgutansqu@icio.us	Gutans
ksimkinqv@census.gov	Simkin
gdoorlyqw@ftc.gov	Doorly
mfairlawqx@tripadvisor.com	Fairlaw
bfrancomqy@utexas.edu	Francom
hdaverinqz@ftc.gov	Daverin
amercyr0@ihg.com	Mercy
htironer1@reference.com	Tirone
tabbyssr2@japanpost.jp	Abbyss
frowbottamr3@bloglines.com	Rowbottam
gkollatschr4@yale.edu	Kollatsch
bbarcker5@wunderground.com	Barcke
gcourtoisr6@bravesites.com	Courtois
kjakovijevicr7@flickr.com	Jakovijevic
lwingeatr8@berkeley.edu	Wingeat
cletchmorer9@hatena.ne.jp	Letchmore
lrichardetra@cornell.edu	Richardet
acrathernrb@google.co.jp	Crathern
athoumasrc@eepurl.com	Thoumas
godoireidhrd@wufoo.com	Doireidh
osemonre@timesonline.co.uk	Semon
heatonrf@networksolutions.com	Eaton
ctotarorg@php.net	Totaro
hgrgicrh@weebly.com	Grgic
dfewellri@goo.gl	Fewell
pkemittrj@live.com	Kemitt
ebrokrk@webs.com	Brok
rfumagallrl@google.it	Fumagall
swegenenrm@xrea.com	Wegenen
lsummersettrn@macromedia.com	Summersett
vdykaro@pbs.org	Dyka
nbonnavantrp@slashdot.org	Bonnavant
ibedderrq@vk.com	Bedder
akinnerrr@loc.gov	Kinner